R 640 480
NO ./pics/wood.png
SO ./pics/bluestone.png
WE ./pics/colorstone.png
EA ./pics/eagle.png
S ./pics/barrel.png
F 63,75,30
C 60,30,60

        1111111111111111111111111 
        1000000000110000011100001 
        1011000001110000010100001 
        1001000000000000010100001 
111111111011000001110000000000001 
100000000011000001110111111011111 
11110111111111011100000010001     
11110111111111011101010010001     
11000002110101011100000000001     
1000000N000000001100000010001     
10000000000000001101010010001     
1100000111010101111101111000111   
11110111 1110101 101111010001     
11111111 1111111 111111111111     