R 640 480
NO ./pics/wood.png
SO ./pics/bluestone.png      
WE ./pics/colorstone.png
EA ./pics/eagle.png
S ./path_to_the_sprite_texture
F 63,75,30
C 60,30,60

1111111111111111111111111
1100000000110000001111111
1111111111111011000001111
1000000000110000011101111
1111011111111101110000001
1111111111111111111111111
1111111111111111111111111
1111111111111111111111111
111111111100000011111111111
111111000000W00011111111111
111111111100000011111111111
1111111111111111111111111