R 1920 1080
NO ./path_to_the_north_texture/textu.png
SO ./path_to_the_south_texture        
WE ./path_to_the_west_texture
EA ./path_to_the_east_texture
S ./path_to_the_sprite_texture
F 0,0,0
C 225,30,0

1111111111111111111111111
1100000000110000001111111
1111111111111011000001111
1000000000110000011101111
1111011111111101110000001
1111111111111111111111111
1111111111111111111111111
1111111111000000111111111
1111111111000000111111101
1111111111000000111111111
1111111111000000111111111
1111111111111111111111111