R 640 480
NO ./pics/sak1.png
SO ./pics/sak3.png
WE ./pics/mossy.png
EA ./pics/colorstone.png
S ./pics/hhh.png
F 49,87,3
C 240,235,240

        1111111111111111111111111 
        1000000000110000011100001 
        1011000001110000010100001 
        1001000000000000010100001 
111111111011000001110000000000001 
100000000011000001110111111011111 
11110111111111011100000010001     
11110111111111011101010010001     
11000000000000001100000000001     
1000200N000000001100000010001     
10000000000000001101010010001     
10002222200000011101111000111   
1111011111110101 101111010001     
11111111 1111111 111111111111     